052 049
02 01 02 01 02 01 02 01 02 01 02 01 02 01 02 01 02 01 02 01 02 01 02 01 02 01 02 01 02 01 02 01 02 01 02 01 02 01 02 01 02 01 02 01 02 01 02 01 02 01 02 01
02 01 02 01 02 01 02 01 02 01 02 01 02 01 02 01 02 01 02 01 02 01 02 01 02 01 02 01 02 01 02 01 02 01 02 01 02 01 02 01 02 01 02 01 02 01 02 01 02 01 02 01
02 01 02 01 02 01 02 01 02 01 02 01 02 01 02 01 02 01 02 01 02 01 02 01 02 01 02 01 02 01 02 01 02 01 02 01 02 01 02 01 02 01 02 01 02 01 02 01 02 01 02 01
02 01 02 01 02 01 02 01 02 01 02 01 02 01 02 01 02 01 02 01 02 01 02 01 02 01 02 01 02 01 02 01 02 01 02 01 02 01 02 01 02 01 02 01 02 01 02 01 02 01 02 01
02 01 02 01 02 01 02 01 02 01 02 01 02 01 02 01 02 01 02 01 02 01 02 01 02 01 02 01 02 01 02 01 02 01 02 01 02 01 02 01 02 01 02 01 02 01 02 01 02 01 02 01
02 01 02 01 02 01 02 01 02 01 02 01 02 01 02 01 02 01 02 01 02 01 02 01 02 01 02 01 02 01 02 01 02 01 02 01 02 01 02 01 02 01 02 01 02 01 02 01 02 01 02 01
02 01 02 01 02 01 02 01 02 01 02 01 02 01 02 01 02 01 02 01 02 01 02 01 02 01 02 01 02 01 02 01 02 01 02 01 02 01 02 01 02 01 02 01 02 01 02 01 02 01 02 01
02 01 02 01 02 01 02 01 02 01 02 01 02 01 02 01 02 01 02 01 02 01 02 01 02 01 02 01 02 01 02 01 02 01 02 01 02 01 02 01 02 01 02 01 02 01 02 01 02 01 02 01
02 01 02 01 02 01 02 01 02 01 02 01 02 01 02 01 02 01 02 01 02 01 02 01 02 01 02 01 02 01 02 01 02 01 02 01 02 01 02 01 02 01 02 01 02 01 02 01 02 01 02 01
02 01 02 01 02 01 02 01 02 01 02 01 02 01 02 01 02 01 02 01 02 01 02 01 02 01 02 01 02 01 02 01 02 01 02 01 02 01 02 01 02 01 02 01 02 01 02 01 02 01 02 01
02 01 02 01 02 01 02 01 02 01 02 01 02 01 02 01 02 01 02 01 02 01 02 01 02 01 02 01 02 01 02 01 02 01 02 01 02 01 02 01 02 01 02 01 02 01 02 01 02 01 02 01
02 01 02 01 02 01 02 01 02 01 02 01 02 01 02 01 02 01 02 01 02 01 02 01 02 01 02 01 02 01 02 01 02 01 02 01 02 01 02 01 02 01 02 01 02 01 02 01 02 01 02 01
02 01 02 01 02 01 02 01 02 01 02 01 02 01 02 01 02 01 02 01 02 01 02 01 02 01 02 01 02 01 02 01 02 01 02 01 02 01 02 01 02 01 02 01 02 01 02 01 02 01 02 44
02 01 02 01 02 01 02 01 02 01 02 01 02 01 02 01 02 01 02 01 02 01 02 01 02 01 02 01 02 01 02 01 02 01 02 01 02 01 02 01 02 01 02 01 02 01 02 01 02 01 02 44
02 01 02 01 02 01 02 01 02 01 02 01 02 01 02 01 02 01 02 01 02 01 02 01 02 01 02 01 02 01 02 01 02 01 02 01 02 01 02 01 02 01 02 01 02 01 02 01 02 01 45 54
02 01 02 01 02 01 02 01 02 01 02 01 02 01 02 01 02 01 02 01 02 01 02 01 02 01 02 01 02 01 02 01 02 01 02 01 02 01 02 01 02 01 02 01 02 01 02 01 02 01 44 01
02 01 02 01 02 01 02 01 02 01 02 01 02 01 02 01 02 01 02 01 02 01 02 01 02 01 02 01 02 01 02 01 02 01 02 01 02 01 02 01 02 01 02 01 02 01 02 01 02 01 44 01
02 01 02 01 02 01 02 01 02 01 02 01 02 01 02 01 02 01 02 01 02 01 02 01 02 01 02 01 02 01 02 01 02 01 02 01 02 01 02 01 02 01 02 01 02 01 02 01 02 01 44 01
02 01 02 01 02 01 02 01 02 01 02 01 02 01 02 01 02 01 02 01 02 01 02 01 02 01 02 01 02 01 02 01 02 01 02 01 02 01 02 01 02 01 02 01 02 01 02 01 02 01 44 01
02 01 02 01 02 01 02 01 02 01 02 01 02 01 02 01 02 01 02 01 02 01 02 01 02 01 02 01 02 01 42 45 53 53 53 46 02 01 02 45 53 53 53 53 53 53 53 46 02 45 54 01
02 01 02 01 02 01 02 01 02 01 02 01 02 01 02 01 02 01 02 01 02 01 02 01 02 01 02 01 02 32 56 44 02 01 02 52 53 53 53 54 02 01 02 01 02 01 02 52 53 54 02 01
02 01 02 01 02 01 02 01 02 01 02 01 02 01 02 01 02 01 02 01 02 01 02 01 02 01 02 01 02 42 02 44 02 01 02 01 02 01 02 01 02 01 02 01 02 01 02 01 02 01 02 01
02 01 02 01 02 01 02 01 02 01 02 01 02 01 02 01 02 01 02 01 02 01 02 01 02 01 02 01 02 42 02 55 34 01 02 01 02 01 02 01 02 01 02 32 33 33 33 34 02 01 02 01
02 01 02 01 02 01 02 01 02 01 02 01 02 01 02 01 02 01 02 01 02 01 02 01 02 01 02 01 02 42 02 01 44 01 02 01 02 01 02 01 02 32 33 56 02 01 02 55 33 34 02 01
02 01 02 01 02 01 02 01 02 01 02 01 02 01 02 01 02 01 02 01 02 01 02 01 02 01 02 01 02 52 46 01 44 01 02 01 02 01 02 01 32 56 01 45 53 53 53 46 02 44 02 01
02 01 02 01 02 01 02 01 02 01 02 01 02 01 02 01 02 01 02 01 02 01 02 01 02 01 02 01 02 01 42 01 44 01 02 01 02 01 02 32 56 02 45 54 02 01 02 52 46 55 34 01
02 01 02 01 02 01 02 01 02 01 02 01 02 01 02 01 02 01 02 01 02 01 02 01 02 01 02 01 02 01 42 01 55 34 02 01 02 32 33 56 02 45 54 01 02 01 02 01 42 01 44 01
02 01 02 01 02 01 02 01 02 01 02 01 02 01 02 01 02 01 02 01 02 01 02 01 02 01 02 01 02 01 52 46 01 55 33 33 33 56 02 45 53 54 02 01 02 01 02 01 42 45 54 01
02 01 02 01 02 01 02 01 02 01 02 01 02 01 02 01 02 01 02 01 02 01 02 01 02 01 02 01 02 01 02 52 46 01 02 01 02 45 53 54 02 01 02 01 02 01 02 32 56 44 02 01
02 01 02 01 02 01 02 01 02 01 02 01 02 01 02 01 02 01 02 01 02 01 02 01 02 01 02 01 02 01 02 01 52 53 53 53 53 54 02 01 02 01 02 01 02 01 02 42 02 44 02 01
02 01 02 01 02 01 02 01 02 01 02 01 02 01 02 01 02 01 02 01 02 01 02 01 02 01 02 01 02 01 02 01 02 01 02 01 02 01 02 01 02 01 02 01 02 01 02 42 02 44 02 02
02 01 02 01 02 01 02 01 02 01 02 01 02 01 02 01 02 01 02 01 02 01 02 01 02 01 02 01 02 01 02 01 02 01 02 01 02 01 02 01 02 01 02 01 02 01 02 52 46 55 34 02
02 01 02 01 02 01 02 01 02 01 02 01 02 01 02 01 02 01 02 01 02 01 02 01 02 01 02 01 02 01 02 01 02 01 02 01 02 01 02 01 02 01 02 01 02 01 02 01 42 01 44 02
02 01 02 01 02 01 02 01 02 01 02 01 02 01 02 01 02 01 02 01 02 01 02 01 02 01 01 32 33 33 33 33 33 33 33 33 33 33 33 33 33 33 33 33 33 33 33 33 56 01 44 02
02 01 02 01 02 01 02 01 02 01 02 01 02 01 02 01 02 01 02 01 02 01 02 01 02 01 02 42 08 09 02 09 09 10 01 01 01 01 01 01 01 01 01 01 01 01 01 01 01 01 44 01
02 01 02 01 02 01 02 01 02 01 02 01 02 01 02 01 02 01 02 01 02 01 02 01 02 01 01 42 15 16 16 16 16 17 01 01 01 01 01 01 01 01 01 01 01 01 01 01 01 01 44 02
02 01 02 01 02 01 02 01 02 01 02 01 02 01 02 01 02 01 02 01 02 01 02 01 02 01 02 42 15 16 16 16 16 17 01 01 01 01 05 01 01 01 01 01 01 01 01 01 01 01 44 01
02 01 02 01 02 01 02 01 02 01 02 01 02 01 02 01 02 01 02 01 02 01 02 01 02 01 01 42 15 16 16 16 16 17 01 01 01 01 05 01 01 01 01 01 01 01 01 01 01 01 44 02
02 01 02 01 02 01 02 01 02 01 02 01 02 01 02 01 02 01 02 01 02 01 02 01 02 01 02 42 22 23 11 23 23 24 03 03 03 03 04 01 01 01 01 01 01 01 01 01 01 01 44 01
02 01 02 01 02 01 02 01 02 01 02 01 02 01 02 01 02 01 02 01 02 01 02 01 02 01 01 42 01 01 01 01 01 01 01 01 01 01 01 01 01 01 01 01 01 01 01 01 01 01 44 02
02 01 02 01 02 01 02 01 02 01 02 01 02 01 02 01 02 01 02 01 02 01 02 01 02 01 02 42 01 01 01 01 01 01 01 01 01 01 01 01 01 01 01 01 01 01 01 01 01 01 44 01
02 01 02 01 02 01 02 01 02 01 02 01 02 01 02 01 02 01 02 01 02 01 02 01 02 01 01 42 01 01 01 01 01 01 01 01 01 01 01 01 01 01 01 01 01 01 01 01 01 01 44 02
02 01 02 01 02 01 02 01 02 01 02 01 02 01 02 01 02 01 02 01 02 01 02 01 02 01 02 42 01 01 01 01 01 01 01 01 01 01 01 01 01 01 01 01 01 45 53 53 53 46 44 01
02 01 02 01 02 01 02 01 02 01 02 01 02 01 02 01 02 01 02 01 02 01 02 01 02 01 01 42 01 01 01 01 01 01 01 01 01 01 01 01 01 01 01 01 01 44 01 02 01 42 44 02
02 01 02 01 02 01 02 01 02 01 02 01 02 01 02 01 02 01 02 01 02 01 02 01 02 01 02 42 01 01 01 01 01 01 01 01 01 01 01 01 01 01 01 45 53 54 02 01 02 42 44 01
02 01 02 01 02 01 02 01 02 01 02 01 02 01 02 01 02 01 02 01 02 01 02 01 02 01 01 42 01 01 01 01 01 01 01 01 01 01 01 01 01 01 01 44 01 02 01 02 01 42 44 02
02 01 02 01 02 01 02 01 02 01 02 01 02 01 02 01 02 01 02 01 02 01 02 01 02 01 02 52 53 53 53 53 53 53 53 53 53 53 53 53 53 53 53 54 02 01 02 01 02 52 54 01
02 01 02 01 02 01 02 01 02 01 02 01 02 01 02 01 02 01 02 01 02 01 02 01 02 01 01 02 01 02 01 02 01 02 01 02 01 02 01 02 01 02 01 02 01 02 01 02 01 02 01 02
w w w w w w w w w w w w w w w w w w w w w w w w w w g g g g g g g g g g g g g g g g g g g g g g g g g g
w w w w w w w w w w w w w w w w w w w w w w w w w w g g g g g g g g g g g g g g g g g g g g g g g g g g
w w w w w w w w w w w w w w w w w w w w w w w w w w g g g g g g g g g g g g g g g g g g g g g g g g g g
w w w w w w w w w w w w w w w w w w w w w w w w w w g g g g g g g g g g g g g g g g g g g g g g g g g g
w w w w w w w w w w w w w w w w w w w w w w w w w w g g g g g g g g g g g g g g g g g g g g g g g g g g
w w w w w w w w w w w w w w w w w w w w w w w w w w g g g g g g g g g g g g g g g g g g g g g g g g g g
w w w w w w w w w w w w w w w w w w w w w w w w w w g g g g g g g g g g g g g g g g g g g g g g g g g g
w w w w w w w w w w w w w w w w w w w w w w w w w w g g g g g g g g g g g g g g g g g g g g g g g g g g
w w w w w w w w w w w w w w w w w w w w w w w w w w g g g g g g g g g g g g g g g g g g g g g g g g g g
w w w w w w w w w w w w w w w w w w w w w w w w w w g g g g g g g g g g g g g g g g g g g g g g g g g g
w w w w w w w w w w w w w w w w w w w w w w w w w w g g g g g g g g g g g g g g g g g g g g g g g g g g
w w w w w w w w w w w w w w w w w w w w w w w w w w g g g g g g g g g g g g g g g g g g g g g g g g g g
w w w w w w w w w w w w w w w w w w w w w w w w w w g g g g g g g g g g g g g g g g g g g g g g g g g g
w w w w w w w w w w w w w w w w w w w w w w w w w w g g g g g g g g g g g g g g g g g g g g g g g g g g
w w w w w w w w w w w w w w w w w w w w w w w w w w g g g g g g g g g g g g g g g g g g g g g g g g g g
w w w w w w w w w w w w w w w w w w w w w w w w w w g g g g g g g g g g g g g g g g g g g g g g g g g g
w w w w w w w w w w w w w w w w w w w w w w w w w w g g g g g g g g g g g g g g g g g g g g g g g g g w
w w w w w w w w w w w w w w w w w w w w w w w w w w g g g g g g g g g g g g g g g g g g g g g g g g g w
w w w w w w w w w w w w w w w w w w w w w w w w w w g g g g g g g g g g g g g g g g g g g g g g g g g w
w w w w w w w w w w w w w w w w w w w w w w w w w w w w g g g g g g g g g g g g g g g g g g g g g g g w
w w w w w w w w w w w w w w w w w w w w w w w w w w w w w w g g g g g g g g g g g g g g g g g g g g g w
w w w w w w w w w w w w w w w w w w w w w w w w w w w w w g g g w w w g g g g g w w w w w w w g g g w w
w w w w w w w w w w w w w w w w w w w w w w w w w w w w w g g g w w w w w w w w w w w w w w w w w w w w
w w w w w w w w w w w w w w w w w w w w w w w w w w w w w g g g g w w w w w w w w w w g g g g g w w w w
w w w w w w w w w w w w w w w w w w w w w w w w w w w w w g g g g w w w w w w w w g g g g g g g g g w w
w w w w w w w w w w w w w w w w w w w w w w w w w w w w w g g g g w w w w w w w g g g g g g g g g g w w
w w w w w w w w w w w w w w w w w w w w w w w w w w w w w w g g g w w w w w w g g g g g w w w g g g g w
w w w w w w w w w w w w w w w w w w w w w w w w w w w w w w g g g g w w w g g g g g g w w w w w g g g w
w w w w w w w w w w w w w w w w w w w w w w w w w w w w w w g g g g g g g g g g g g w w w w w w g g g w
w w w w w w w w w w w w w w w w w w w w w w w w w w w w w w w g g g g g g g g g w w w w w w w g g g w w
w w w w w w w w w w w w w w w w w w w w w w w w w w w w w w w w g g g g g g w w w w w w w w w g g g w w
w w w w w w w w w w w w w w w w w w w w w w w w w w w w w w w w w w w w w w w w w w w w w w w g g g w w
w w w w w w w w w w w w w w w w w w w w w w w w w w w w w w w w w w w w w w w w w w w w w w w g g g g w
w w w w w w w w w w w w w w w w w w w w w w w w w w w w w w w w w w w w w w w w w w w w w w w w g g g w
w w w w w w w w w w w w w w w w w w w w w w w w w w w g g g g g g g g g g g g g g g g g g g g g g g g w
w w w w w w w w w w w w w w w w w w w w w w w w w w w g h h h h h h g g g g g g g g g g g g g g g g g w
w w w w w w w w w w w w w w w w w w w w w w w w w w w g h h h h h h g g g g g g g g g g g g g g g g g w
w w w w w w w w w w w w w w w w w w w w w w w w w w w g h h h h h h g g g g f g g g g g g g g g g g g w
w w w w w w w w w w w w w w w w w w w w w w w w w w w g h h h h h h g g g g f g g g g g g g g g g g g w
w w w w w w w w w w w w w w w w w w w w w w w w w w w g h h h h h h f f f f f g g g g g g g g g g g g w
w w w w w w w w w w w w w w w w w w w w w w w w w w w g g g g g g g g g g g g g g g g g g g g g g g g w
w w w w w w w w w w w w w w w w w w w w w w w w w w w g g g g g g g g g g g g g g g g g g g g g g g g w
w w w w w w w w w w w w w w w w w w w w w w w w w w w g g g g g g g g g g g g g g g g g g g g g g g g w
w w w w w w w w w w w w w w w w w w w w w w w w w w w g g g g g g g g g g g g g g g g g g g g g g g g w
w w w w w w w w w w w w w w w w w w w w w w w w w w w g g g g g g g g g g g g g g g g g g g w w w g g w
w w w w w w w w w w w w w w w w w w w w w w w w w w w g g g g g g g g g g g g g g g g g g g w w w g g w
w w w w w w w w w w w w w w w w w w w w w w w w w w w g g g g g g g g g g g g g g g g g w w w w w g g w
w w w w w w w w w w w w w w w w w w w w w w w w w w w g g g g g g g g g g g g g g g g g w w w w w g g w
w w w w w w w w w w w w w w w w w w w w w w w w w w w w w w w w w w w w w w w w w w w w w w w w w w w w