5 5
1 1 1 1 6
1 1 1 1 12
1 1 1 1 4
1 1 1 1 3
1 1 1 1 2
g g g g g
g g g g g
g g g g g
g g g g g
g g g g g